####################
####################
######         #####
######         #####
######         #####
#########  #########
#########  #########
######    @    #####
###### $*% %*$ #####
###### **   ** #####
######         #####
####################
####################
####################
