####################
####################
######         #####
###### % %@% % #####
######         #####
#########**#########
#########**#########
######         #####
######         #####
######         #####
######         #####
####################
####################
####################
