####################
#### %          ####
#### %  *  *  * ####
#### $   * * *  ####
#### %    ***   ####
#### %  ******* ####
#### %    ***   ####
#### %   * * *  ####
#### %  *  *  * ####
#### %          ####
#### %          ####
#### %%%%%%%%$%%####
####@           ####
####################
