####################
####################
####################
####        *   ####
####------------####
####*    ## *   ####
###### $ ## *   ####
####     ##     ####
####%%%$%##%$%%*####
####      @     ####
####            ####
####################
####################
####################
