####################
#*################*#
#%#                #
#                  #
##                 #
##                ##
##                ##
##                ##
##%       @       ##
##                ##
####################
####################
####################
####################

should have no solution!
