####################
####################
####################
####################
####################
####            ####
#*@%  % % % % % ####
####* ##############
####################
####################
####################
####################
####################
####################
