####################
#*################*#
#                  #
#     %      %     #
##    *      *    ##
##      *  *      ##
##     %    %     ##
##                ##
##  %     @    %  ##
##                ##
####################
